40;40
4 4 4 4 4 4 4 4 4 4 4 4 4 4 4 4 4 4 4 4 4 4 4 4 4 4 4 4 4 4 4 4 4 4 4 4 4 4 4 4
4 . . . . 0 . . . . . 4 4 . . . . . . . 1 . . . . . . . . . . . . . . . . . . 4
4 . . . . . . . . . . 4 4 . . . . . . . . . . . . . 0 . . . . . . . . . . . . 4
4 . . 4 4 4 4 4 4 4 4 4 4 . . 4 4 . . 4 4 4 4 4 4 4 4 4 4 4 4 4 4 4 4 4 4 . . 4
4 . . 4 4 4 4 4 4 4 4 4 4 . . 4 4 . . 4 4 4 4 4 4 4 4 4 4 4 4 4 4 4 4 4 4 . . 4
4 . . . . . . 4 4 . . . . . . 4 4 . . 4 4 . . . . . . 4 4 . . . . . . . . . . 4
4 . . . . . . 4 4 . . . . . . 4 4 . . 4 4 . . . . . . 4 4 . . . . . . . . . . 4
4 . . 4 4 4 4 4 4 . . 4 4 4 4 4 4 . . 4 4 . . 4 4 4 4 4 4 . . 4 4 4 4 4 4 . . 4
4 . . 4 4 4 4 4 4 . . 4 4 4 4 4 4 . . 4 4 1 . 4 4 4 4 4 4 . . 4 4 4 4 4 4 . . 4
4 . . . . . . . . . . 4 4 . . . . . . 4 4 . . . . . . 4 4 . . 4 4 . . . 1 . . 4
4 . . . . . . . . . . 4 4 . . 0 . . . 4 4 . . . . . . 4 4 . . 4 4 . . . . . . 4
4 . . 4 4 4 4 4 4 . . 4 4 4 4 4 4 4 4 4 4 . . 4 4 4 4 4 4 5 . 4 4 . . 4 4 . . 4
4 . . 4 4 4 4 4 4 . . 4 4 4 4 4 4 4 4 4 4 . . 4 4 4 4 4 4 5 . 4 4 . . 4 4 . . 4
4 . . . . . . 4 4 . . 4 4 . . . 1 . . . . . . 4 4 . 5 5 . . . 4 4 . . 4 4 . . 4
4 1 . . . . . 4 4 . . 4 4 . . . . . . . . . . 4 4 . . . . . . 4 4 . . 4 4 . . 4
4 4 4 4 4 . . 4 4 . . 4 4 4 4 4 4 . . 4 4 . . 4 4 4 4 4 4 4 4 4 4 . . 4 4 5 . 4
4 4 4 4 4 . . 4 4 . . 4 4 4 4 4 4 . . 4 4 . . 4 4 4 4 4 4 4 4 4 4 . . 4 4 5 . 4
4 . . . . . . 4 4 . . 4 4 . . . . . . 4 4 0 . 4 4 . . 4 4 . . . . . . 4 4 . . 4
4 . . 1 . . . 4 4 . . 4 4 . . . . . . 4 4 0 . 4 4 . . 4 4 . . . . . . 4 4 . . 4
4 4 4 4 4 4 4 4 4 . . 4 4 4 4 4 4 4 4 4 4 . . 4 4 . . 4 4 . . 4 4 4 4 4 4 . . 4
4 4 4 4 4 4 4 4 4 . . 4 4 4 4 4 4 4 4 4 4 . . 4 4 . . 4 4 . . 4 4 4 4 4 4 . . 4
4 5 5 4 4 . . . . . . . 1 . . 4 4 . . . . . . . . . . . . . . 4 4 . . . . . . 4
4 5 . 4 4 . . . . . . . . . . 4 4 . . . 1 . . . . 5 5 . . . . 4 4 0 . . . . . 4
4 . . 4 4 . . 4 4 4 4 4 4 4 4 4 4 4 4 4 4 . . 4 4 4 4 4 4 4 4 4 4 . . 4 4 . . 4
4 . . 4 4 . . 4 4 4 4 4 4 4 4 4 4 4 4 4 4 . . 4 4 4 4 4 4 4 4 4 4 . . 4 4 . . 4
4 . . 0 . . . . . . . 4 4 . . . . 1 . . . . . 4 4 . . 1 . 5 5 . . . . 4 4 . . 4
4 . . . . . . . . . . 4 4 . . . . . . . . . . 4 4 . . . . . . . . . . 4 4 . . 4
4 4 4 4 4 0 . 4 4 . . 4 4 . . 4 4 4 4 4 4 4 4 4 4 . . 4 4 . . 4 4 4 4 4 4 . . 4
4 4 4 4 4 . . 4 4 1 . 4 4 0 . 4 4 4 4 4 4 4 4 4 4 . . 4 4 . . 4 4 4 4 4 4 . . 4
4 . . . 0 . . 4 4 1 . 4 4 . . . . . . . . . . 4 4 . . 4 4 . . 4 4 . . . . . . 4
4 . 5 . . . . 4 4 . . 4 4 . 5 5 . . . . 1 . . 4 4 1 . 4 4 . . 4 4 . . . . . . 4
4 4 4 4 4 4 4 4 4 . . 4 4 4 4 4 4 4 4 4 4 4 4 4 4 . . 4 4 4 4 4 4 . . 4 4 . . 4
4 4 4 4 4 4 4 4 4 . . 4 4 4 4 4 4 4 4 4 4 4 4 4 4 . . 4 4 4 4 4 4 1 . 4 4 . . 4
4 0 0 . . . . 4 4 . . . . . . 4 4 . . . . . . 4 4 . . 4 4 . . 4 4 . . 4 4 . . 4
4 . . . . . . 4 4 . 5 5 . . . 4 4 . . . . . . 4 4 . . 4 4 . . 4 4 . . 4 4 . . 4
4 . . 4 4 4 4 4 4 4 4 4 4 . . 4 4 . . 4 4 4 4 4 4 . . 4 4 . . 4 4 . . 4 4 4 4 4
4 5 . 4 4 4 4 4 4 4 4 4 4 . . 4 4 . . 4 4 4 4 4 4 . . 4 4 . . 4 4 . . 4 4 4 4 4
4 . . . . . . . . . 1 . . . . . . . . 4 4 . . . . . . 4 4 . . . . . . . . . 5 4
4 . . 5 5 5 . . . . . . . . . . . . . 4 4 . . 5 5 5 . 4 4 . . . . . . . . . 5 4
4 4 4 4 4 4 4 4 4 4 4 4 4 4 4 4 4 4 4 4 4 4 4 4 4 4 4 4 4 4 4 4 4 4 4 4 4 4 4 4
#
0;1;2
#
