40;40
4 4 4 4 4 4 4 4 4 4 4 4 4 4 4 4 4 4 4 4 4 4 4 4 4 4 4 4 4 4 4 4 4 4 4 4 4 4 4 4
4 . . . . . . . . . . 4 4 . . . . . . . . . . . . . . . . . . . . . . . . . . 4
4 . . . . . . . . . . 4 4 . . . . . . . . . . . . . . . . . . . . . . . . . . 4
4 . . 4 4 4 4 4 4 4 4 4 4 . . 4 4 . . 4 4 4 4 4 4 4 4 4 4 4 4 4 4 4 4 4 4 . . 4
4 . . 4 4 4 4 4 4 4 4 4 4 . . 4 4 . . 4 4 4 4 4 4 4 4 4 4 4 4 4 4 4 4 4 4 . . 4
4 . . . . . . 4 4 . . . . . . 4 4 . . 4 4 . . . . . . 4 4 . . . . . . . . . . 4
4 . . . . . . 4 4 . . . . . . 4 4 . . 4 4 . . . . . . 4 4 . . . . . . . . . . 4
4 . . 4 4 4 4 4 4 . . 4 4 4 4 4 4 . . 4 4 . . 4 4 4 4 4 4 . . 4 4 4 4 4 4 . . 4
4 . . 4 4 4 4 4 4 . . 4 4 4 4 4 4 . . 4 4 . . 4 4 4 4 4 4 . . 4 4 4 4 4 4 . . 4
4 . . . . . . . . . . 4 4 . . . . . . 4 4 . . . . . . 4 4 . . 4 4 . . . . . . 4
4 . . . . . . . . . . 4 4 . . . . . . 4 4 . . . . . . 4 4 . . 4 4 . . . . . . 4
4 . . 4 4 4 4 4 4 . . 4 4 4 4 4 4 4 4 4 4 . . 4 4 4 4 4 4 . . 4 4 . . 4 4 . . 4
4 . . 4 4 4 4 4 4 . . 4 4 4 4 4 4 4 4 4 4 . . 4 4 4 4 4 4 . . 4 4 . . 4 4 . . 4
4 . . . . . . 4 4 . . 4 4 . . . . . . . . . . 4 4 . . . . . . 4 4 . . 4 4 . . 4
4 . . . . . . 4 4 . . 4 4 . . . . . . . . . . 4 4 . . . . . . 4 4 . . 4 4 . . 4
4 4 4 4 4 . . 4 4 . . 4 4 4 4 4 4 . . 4 4 . . 4 4 4 4 4 4 4 4 4 4 . . 4 4 . . 4
4 4 4 4 4 . . 4 4 . . 4 4 4 4 4 4 . . 4 4 . . 4 4 4 4 4 4 4 4 4 4 . . 4 4 . . 4
4 . . . . . . 4 4 . . 4 4 . . . . . . 4 4 . . 4 4 . . 4 4 . . . . . . 4 4 . . 4
4 . . . . . . 4 4 . . 4 4 . . . . . . 4 4 . . 4 4 . . 4 4 . . . . . . 4 4 . . 4
4 4 4 4 4 4 4 4 4 . . 4 4 4 4 4 4 4 4 4 4 . . 4 4 . . 4 4 . . 4 4 4 4 4 4 . . 4
4 4 4 4 4 4 4 4 4 . . 4 4 4 4 4 4 4 4 4 4 . . 4 4 . . 4 4 . . 4 4 4 4 4 4 . . 4
4 . . 4 4 . . . . . . . . . . 4 4 . . . . . . . . . . . . . . 4 4 . . . . . . 4
4 . . 4 4 . . . . . . . . . . 4 4 . . . . . . . . . . . . . . 4 4 . . . . . . 4
4 . . 4 4 . . 4 4 4 4 4 4 4 4 4 4 4 4 4 4 . . 4 4 4 4 4 4 4 4 4 4 . . 4 4 . . 4
4 . . 4 4 . . 4 4 4 4 4 4 4 4 4 4 4 4 4 4 . . 4 4 4 4 4 4 4 4 4 4 . . 4 4 . . 4
4 . . . . . . . . . . 4 4 . . . . . . . . . . 4 4 . . . . . . . . . . 4 4 . . 4
4 . . . . . . . . . . 4 4 . . . . . . . . . . 4 4 . . . . . . . . . . 4 4 . . 4
4 4 4 4 4 . . 4 4 . . 4 4 . . 4 4 4 4 4 4 4 4 4 4 . . 4 4 . . 4 4 4 4 4 4 . . 4
4 4 4 4 4 . . 4 4 . . 4 4 . . 4 4 4 4 4 4 4 4 4 4 . . 4 4 . . 4 4 4 4 4 4 . . 4
4 . . . . . . 4 4 . . 4 4 . . . . . . . . . . 4 4 . . 4 4 . . 4 4 . . . . . . 4
4 . . . . . . 4 4 . . 4 4 . . . . . . . . . . 4 4 . . 4 4 . . 4 4 . . . . . . 4
4 4 4 4 4 4 4 4 4 . . 4 4 4 4 4 4 4 4 4 4 4 4 4 4 . . 4 4 4 4 4 4 . . 4 4 . . 4
4 4 4 4 4 4 4 4 4 . . 4 4 4 4 4 4 4 4 4 4 4 4 4 4 . . 4 4 4 4 4 4 . . 4 4 . . 4
4 . . . . . . 4 4 . . . . . . 4 4 . . . . . . 4 4 . . 4 4 . . 4 4 . . 4 4 . . 4
4 . . . . . . 4 4 . . . . . . 4 4 . . . . . . 4 4 . . 4 4 . . 4 4 . . 4 4 . . 4
4 . . 4 4 4 4 4 4 4 4 4 4 . . 4 4 . . 4 4 4 4 4 4 . . 4 4 . . 4 4 . . 4 4 4 4 4
4 . . 4 4 4 4 4 4 4 4 4 4 . . 4 4 . . 4 4 4 4 4 4 . . 4 4 . . 4 4 . . 4 4 4 4 4
4 . . . . . . . . . . . . . . . . . . 4 4 . . . . . . 4 4 . . . . . . . . . 5 4
4 . . . . . . . . . . . . . . . . . . 4 4 . . . . . . 4 4 . . . . . . . . . 5 4
4 4 4 4 4 4 4 4 4 4 4 4 4 4 4 4 4 4 4 4 4 4 4 4 4 4 4 4 4 4 4 4 4 4 4 4 4 4 4 4
#
#
