10;10
4 4 4 4 4 4 4 4 4 4
4 . . . . . . . . 4
4 . . . . . . . . 4
4 . . . . . . . . 4
4 . . . . . . . . 4
4 3 4 . . 4 3 4 3 4
4 . . . . . . . . 4
4 . . 5 5 5 . . . 4
4 . . . . 5 . . . 4
4 4 4 4 4 4 4 4 4 4
#
0;1;3
0;4;5
0;2;3
0;2;4
0;7;1
0;7;2
0;7;3
0;7;8
6;3;1
6;5;1
#
