15;30
4 4 4 4 4 4 4 4 4 4 4 4 4 4 4
4 . . . . 2 . . . . . . . . 4
4 . . . . . . . . . . . . 5 4
4 . . . . . . . 5 5 . . . 5 4
4 . . . . . . . . 5 . . . 5 4
4 . . . . . . . . 1 . . . . 4
4 . . . 3 . . . . . . . . . 4
4 . . . 3 . . . . . . . . . 4
4 . . . 3 . . . . . . . . . 4
4 . . . 3 . . . . . . . . . 4
4 . . . 3 . . . . . . . . . 4
4 . . . 3 . . . . . . . . . 4
4 . . . 3 . . . . . . . . . 4
4 . . . 3 . . . . . . . . . 4
4 . . . 3 . . . . . . . . . 4
4 . . . 3 . . . . . . . . . 4
4 . . . 3 . . . . . . . . . 4
4 . . . 3 . . . . . . . . . 4
4 . . . 3 . . . . . . . . . 4
4 . . . 3 . . . . . . . . . 4
4 . . . 3 . . . . . . . . . 4
4 . . . 3 . . . . . . . . . 4
4 . . . 3 . . . . . . . . . 4
4 . . . 3 . . . . . . . . . 4
4 . . . 3 . . . . . . . . . 4
4 . . . 3 . . . . . . . . . 4
4 . . . 3 . . . . . . . . . 4
4 . . . 3 . . . . . . . . . 4
4 . . . 3 . . . . . . . . . 4
4 4 4 4 4 4 4 4 4 4 4 4 4 4 4
#
0;1;3
0;1;4
0;1;5
3;1;6
#
