10;10
4 4 4 4 4 4 4 4 4 4
4 . . . . . . . . 4
4 . . . . . . . . 4
4 . . . . . . . . 4
4 . . . . . . . . 4
4 3 3 3 . 3 3 3 3 4
4 . . . . . . . . 4
4 . . 5 5 5 5 . . 4
4 . . . . 5 5 . . 4
4 4 4 4 4 4 4 4 4 4
#
0;2;3 
0;7;8 
0;1;4 
0;5;4 
0;6;6 
0;7;7 
0;2;8 
0;3;4 
0;3;1 
0;1;6 
#
