10;10
4 4 4 4 4 4 4 4 4 4
4 . . . . . . . . 4
4 . . . . . . . . 4
4 . . . . . . . . 4
4 . . . . . . . . 4
4 3 3 3 . 3 3 3 3 4
4 . . . . . . . . 4
4 . . 5 5 5 5 . . 4
4 . . . . 5 5 . . 4
4 4 4 4 4 4 4 4 4 4
#
0;5;4
1;8;4
0;3;2
1;8;1
0;2;3
0;6;3
0;5;1
0;2;6
1;2;4
2;4;3
6;4;8
6;3;8
6;2;8
6;1;8
#
