10;10
4 4 4 4 4 4 4 4 4 4 
4 . . . . . . . . 4 
4 . . . . . . . . 4 
4 . . . . . . . . 4 
4 . . . . . . . . 4 
4 3 3 3 . 3 3 3 3 4 
4 . . . . . . . . 4 
4 . . 5 5 5 5 . . 4 
4 . . . . 5 5 . . 4 
4 4 4 4 4 4 4 4 4 4 
#
0;5;2 
0;4;1 
1;8;3 
0;3;1 
2;1;7 
2;2;3 
0;8;7 
2;1;4 
0;7;7 
0;2;4 
#
