10;10
4 4 4 4 4 4 4 4 4 4
4 . . . . . . . . 4
4 . . . . . . . . 4
4 . . . . . . . . 4
4 . . . . . . . . 4
4 3 3 3 . 3 3 3 3 4
4 . . . . . . . . 4
4 . . 5 5 5 5 . . 4
4 . . . . 5 5 . . 4
4 4 4 4 4 4 4 4 4 4
#
0;1;3
1;4;5
0;2;3
0;2;4
2;7;1
0;7;2
2;7;3
3;7;8
60;7;7
60;4;8
60;2;2
62;5;1
61;8;1
63;8;2
#
